0,0,0,0,0,0,0,0,0,0,0,0,0,
0,5,0,1,0,1,0,1,0,1,0,5,0,
0,1,0,3,0,1,0,1,0,1,0,1,0,
0,3,0,4,0,1,5,1,0,1,0,1,0,
0,4,0,1,0,1,0,1,0,6,0,1,0,
0,1,0,6,0,0,0,0,0,1,0,1,0,
0,0,0,0,0,0,0,0,0,0,0,0,0,
0,0,0,0,0,0,0,0,0,0,0,0,0,
0,0,0,0,0,7,7,7,0,0,0,0,0,
0,6,1,0,0,7,7,7,0,0,1,1,0,
0,1,1,0,0,7,7,7,0,0,1,1,0,
0,1,1,0,0,0,0,0,0,0,1,1,0,
0,1,1,0,0,0,0,0,0,0,1,1,0,
0,1,1,0,0,0,0,0,0,0,1,6,0,
0,0,0,0,0,1,1,1,0,0,0,0,0,
0,0,0,1,0,0,0,0,0,1,0,0,0,
0,1,0,1,0,0,0,0,0,1,0,1,0,
0,1,0,0,0,1,1,1,0,0,0,1,0,
0,0,0,0,0,1,8,1,0,0,0,0,0,
